NO ./assets/textures/peinture.xpm 
SO ./assets/textures/carreaux.xpm
WE ./assets/textures/herbe.xpm
EA ./assets/textures/parquet.xpm

F 135,206,235
C 125,252,0

111111111111111111
100100001000000001
100100001000000001
100000000000000001
100000000111100001
100000N00000000001
100100000000000001
100100000000000001
111111111111111111