NO ./assets/textures/fox.xpm 
SO ./assets/textures/owl.xpm
WE ./assets/textures/wolf.xpm
EA ./assets/textures/squirrel.xpm
NO ./assets/textures/fox.xpm

F 192,192,192
C 129,129,129

111111111111111111
100100001000000001
100100001000000001
100000000000000001
100000000000000001
100000000000000001
100100N00000000001
100100000000000001
111111111111111111