NO ./assets/textures/fox.xpm 
SO ./assets/textures/owl.xpm
WE ./assets/textures/wolf.xpm
EA ./assets/textures/squirrel.xpm

F 192,192,192
C 129,129,129

    1111111111111111111111111111111111111111111111111
    1111000000000000000000000100000000000000000000001
11111000000000000111100000000100000000000000000000001
10000110000000000000000000000100000000000000011111111
10000000000000000W0000000000010000000000000001
1000000000100011100010000000000000000000000001
1000000000100000100001000000000000000000000001111111111111
1000000000100011100000100000000000000000000001
1000000000100000000000000001100000000000000001
1111111111111111111111111111111111111111111111